..##.....T
#T#...###.
#.#E#E###E
#..E.###..
###T#####G