..##.....T
#T##..###.
#E##EE###E
#E.EE###..
###T#####G