..##.....T
#T#...###.
#.##EE###E
#..E.###..
###T#####G